11111111111111111111
15001110100010001011
10111000101010101011
10001011101010101011
11101111111011101011
10000000000000000011
10111111011111111101
10001010010001100001
10101010110101101111
10101010001101100001
10101011101001111101
10100010001011000001
10111111111011011111
14000000000000000001
11111111011111111101
10001100000101110001
11100101110101000101
10110101000101011101
10000001011100010061
11111111111111111111