11111111111111111111
10000000001100001161
10110111101101100001
10010110100001111111
11000100110111000001
11011101110111110111
10010000000000110111
10110111011110110111
10110010010010110001
10111010110110111101
10001011100000001101
11101010001111101101
11101111111111101101
10000010110000000001
10111010000111101111
10111011110111100001
10100001010105101101
10101101010101101111
10101001000100000001
11111111111111111111