11111111111111111111
10100001111110000001
10110111000000111101
10110111111011150001
10000001011000111111
11111101011110000001
10111101000111011101
10111101110111000101
10111101110000010101
10111101011110111101
16000001000000100101
11101111111110101101
11101000000110101101
10101111110110100001
10100000110100111101
10001110110101100001
11011110000111101111
11011010101100001101
11000011100001100001
11111111111111111111