11111111111111111111
10011011100000000001
11011000001101101111
10000011101101100011
10111011111001111011
10001011001011111011
11101011011011000011
11101111000010111011
10000001101110101111
10110100100000101001
10110110111111101101
10110110000100000101
10110010110101110001
10111010100101111011
10101010101101100011
10100010100000101001
10111110111110111101
10111010100010110101
10000010111000110001
11111111111111111111 