11111111111111111111
11111111111111111011
11000000000000001001
10011111111111101101
10111100000001100101
10010001111101110101
11011011000101000101
11001010010101011101
11101010110101000101
11101010110101110101
10001010110101110101
10111010100101000101
10111010111101011101
10001010000001000101
11101011111111110101
11101000000001110101
11001111111100000101
11000000000111111101
11111111110000000001
11111111111111111111