11111111111111111111
10000111000100000001
10111001010111110101
10011101110001100101
11000001111101111101
11011111011100000001
10011000010001111111
10111010110111000111
10111110110111010111
10000000110001010001
11101111111101110101
11100001000001110111
10001101111100000011
10111100011101111011
10100101000001001001
10110111011101101101
10000010001101100101
10111010100100110101
10001010110110000111
11111111111111111111