11111111111111111111
10000000000000000001
10101111011101111101
10101111011001110001
10100001010011000101
10111101011111111101
10000111000101000001
10111111111100011101
10000000110111111101
10111110000110000001
10110011011111111101
10100111111010000101
10001010111011110001
10111010110010011101
10110010010111000001
10110111010101111101
10110111010100001101
10110111010111101101
10000000000000000001
11111111111111111111