11111111111111111111
10000000060011000001
10111110111000011101
10001010111011110101
11111011100010010001
10000000101111011011
10110110001000011011
10010111101111000011
11110001101111111111
11011111000000000001
11011001101111111101
11000011101111000101
11011000000001110101
10011110111101100101
10110110001101101101
10110111101111000001
10000150101010011101
11101110101010111001
10000000100010001111
11111111111111111111