11111111111111111111
10001000011000010001
10101011111111010101
10101000011001010101
10101011111111010101
10101000011000010101
10101011111111010101
10100000011000000101
10111111111111111101
10000000060000000001
11101111111111111111
10001000000000000001
10111011111111111101
10001011100001105101
11101001001100001101
11101101101111100101
10000001100001111101
10111111111100000001
10000001100001111101
11111111111111111111