11111111111111111111
10000010000000100001
10101110110110101101
10101110010100100101
10101000110101110101
10101011110100010101
10101110006110110101
10111000110010000101
10000011111111111101
11111010000000000001
10000010111111111111
10111110100001000001
10100010101111011011
10001110100000011011
10111010110111110001
10000010000011000111
11111110111010011101
10000110111011011001
15110000100010000011
11111111111111111111